########
#hello #
# #  #a#
# world#
# #WW# #
#ds##f #
# WW   #
########